                
                
NNNNNNNNNNNNNNNN
NNNNNNCNNNNNNNNN
NNNNNNNNNNNNNNNN
rrrrrrrrrrrrrrrr
rrrrrrrrrrrrrrrr
SSSSSTSSSSSSSSSS
SSSSSTEESSSSSSSS
SSSSSTEESSSSSSSS
SSSSSTSSSSSSSSSS