                
                
NNN   NNN       
NNNNNNNNNNN   NN
NNN   NNNNN   NN
NNN   NNNNN   NN
NNN   NNNNNNDNNN
SSSSppSSSSggrrSS
SSSSSSSSSSSSrrSS
SSSSSSSSSSSDrrSS
SSSSccSSSSSSrrSS