                
                
NNNNNNNNNNNNNNNN
NNNNNNCNNNNNNNNN
NNNNNNNNNNNNNDNN
rrrrrrrrrrrrrrrr
rrrrrrrrrrrrrrrr
SSSSSTSSSSSSSDSS
SSSSSTEESSSSSSSS
SSSSSTEESSSSSSSS
SSSSSTSSSSSSSSSS